1
33
16
4 6 9 7 6 0 3 4 6 0 8 5 1 2 1 8
9 6 0 3 8 7 1 3 3 4 1 2 9 5 5 3
4 4 3 0 6 6 6 2 9 6 7 2 1 0 1 0
6 1 3 6 0 4 9 5 1 3 7 0 8 2 5 4
8 8 6 4 7 4 6 6 1 5 8 2 5 1 2 3
4 7 0 4 2 1 9 5 4 8 5 5 2 0 9 2
9 8 6 6 2 4 4 5 1 4 9 8 6 3 2 0
1 4 7 5 5 8 0 0 7 5 5 1 7 6 4 8
4 2 6 9 7 0 4 0 5 4 9 3 7 3 3 0
9 2 5 6 1 5 8 0 2 3 1 0 2 5 0 6
8 7 7 7 9 2 9 6 8 0 9 7 3 5 8 4
7 3 1 0 1 9 0 3 5 2 5 7 9 8 5 9
5 3 8 6 7 8 3 5 8 2 2 4 9 2 8 7
6 1 9 9 1 0 2 8 4 0 7 5 8 2 5 5
7 3 1 4 3 4 1 4 9 4 0 8 8 8 7 4
2 7 5 5 9 0 3 3 0 0 8 0 4 5 5 2
1 8 8 6 5 0 0 6 6 0 6 4 1 4 1 3
3 6 8 2 6 3 7 8 3 7 8 7 3 5 1 6
6 0 2 1 2 3 7 8 5 3 4 6 9 5 1 2
4 9 6 2 4 3 1 7 3 1 7 6 9 8 4 5
0 6 8 2 1 7 2 7 2 7 3 2 4 5 6 8
6 5 3 1 8 6 0 1 7 9 9 8 8 3 5 0
2 3 3 3 2 7 0 5 4 6 7 1 3 5 1 1
0 4 4 1 0 5 4 0 4 4 8 4 9 4 7 3
9 2 7 2 9 9 7 6 7 6 7 0 1 8 4 2
3 8 5 3 5 9 5 2 5 4 8 7 0 5 0 1
7 9 3 9 1 2 5 8 8 2 1 2 2 5 6 5
5 1 1 1 0 6 5 6 2 3 3 2 1 5 4 8
5 9 9 6 2 4 4 2 8 7 4 1 2 0 8 8
3 9 1 4 8 6 2 0 1 5 5 2 0 9 3 7
0 2 3 2 7 0 7 7 7 1 8 0 4 7 0 7
8 3 3 6 1 5 9 2 2 4 5 5 5 8 2 7
2 6 2 1 8 9 9 5 0 7 7 6 6 9 4 5
